###########################################################
#                      %                                  #
#            ###################################          #
#                                                         #
########            #######                      ##########
#                                                         #
#       #####    ###############      ################    #
#                                                         #
#                            $                            #
#                                                         #
#     #######################################             #
#                                                         #
#          ########################      ##################
#                                                         #
###########################################################